border_size=1
usage=map

       Wo,       Wo,       Wo,       Wo,       Wo,       Wo,       Wo,       Wo,       Wo,       Ww,       Ww,       Mm,       Mm,       Mm,       Mm,       Mm,       Hh,    Gs^Fp,    Gs^Fp,    Gs^Fp,    Gs^Fp,    Gs^Fp,    Gs^Fp,    Gs^Fp,       Ww,       Ww,    Gs^Fp,    Gs^Fp,       Hh,       Mm,       Mm,       Mm,       Mm,       Mm,       Mm,       Mm,       Mm,       Mm,       Mm,       Mm
       Wo,       Wo,       Wo,       Wo,       Wo,       Wo,       Wo,       Wo,       Wo,       Ww,       Ww,       Mm,       Mm,       Mm,       Mm,       Mm,       Hh,    Gs^Fp,    Gs^Fp,    Gs^Fp,    Gs^Fp,    Gs^Fp,    Gs^Fp,    Gs^Fp,       Ww,       Ww,    Gs^Fp,    Gs^Fp,       Hh,       Mm,       Mm,       Mm,       Mm,       Mm,       Mm,       Mm,       Mm,       Mm,       Mm,       Mm
       Wo,       Wo,       Wo,       Wo,       Wo,       Wo,       Wo,       Wo,       Wo,       Wo,       Ww,       Mm,       Mm,       Mm,       Hh,       Mm,       Hh,    Gs^Fp,    Gs^Fp,    Gg^Ve,    Gs^Fp,    Gs^Fp,    Gs^Fp,       Ww,    Gs^Fp,    Gs^Fp,    Gs^Fp,    Gs^Fp,       Mm,       Mm,       Mm,       Mm,       Mm,       Mm,       Mm,       Mm,       Mm,       Mm,       Mm,       Mm
       Wo,       Wo,       Wo,       Wo,       Wo,       Wo,       Wo,       Wo,       Wo,       Wo,       Wo,       Ww,       Mm,       Mm,       Hh,    Gs^Fp,    Gs^Fp,    Gs^Fp,       Ds,    Gs^Fp,       Ww,       Ww,       Ww,       Ww,    Gs^Fp,    Gg^Ve,       Hh,       Hh,       Mm,       Mm,       Mm,       Mm,       Mm,       Mm,       Mm,       Mm,       Mm,       Mm,       Mm,       Mm
       Wo,       Wo,       Wo,       Wo,       Wo,       Wo,       Wo,       Wo,       Wo,       Wo,       Wo,       Ww,       Ww,       Gg,    Gs^Fp,    Gg^Ve,       Gg,       Ds,       Ww,       Ww,       Ww,       Ww,       Gg,    Gs^Fp,       Mm,       Hh,       Mm,       Mm,       Mm,       Mm,       Mm,       Mm,    Gg^Ve,       Mm,       Mm,       Mm,       Mm,       Mm,       Mm,       Mm
       Wo,       Wo,       Wo,       Wo,       Wo,       Wo,       Wo,       Wo,       Wo,       Wo,       Wo,       Wo,       Ww,       Gg,       Gg,       Gg,       Ds,       Ww,       Ww,       Ww,       Ds,       Gg,    Gs^Fp,       Hh,       Mm,       Mm,       Mm,       Mm,       Mm,       Mm,       Mm,       Mm,       Hh,       Hh,       Mm,       Mm,       Hh,       Mm,       Mm,       Mm
       Wo,       Wo,       Wo,       Wo,       Wo,       Wo,       Wo,       Wo,       Wo,       Wo,       Wo,       Wo,       Ww,       Ds,       Ds,       Ds,       Ww,       Ww,       Ww,       Ww,       Gg,       Gg,       Hh,       Mm,       Hh,       Mm,       Mm,       Mm,       Mm,       Hh,       Mm,       Mm,       Hh,       Hh,       Hh,       Mm,       Mm,       Hh,       Mm,       Mm
       Wo,       Wo,       Wo,       Wo,       Wo,       Wo,       Wo,       Wo,       Wo,       Wo,       Wo,       Wo,       Ww,       Ww,       Ww,       Ww,       Ww,       Ww,       Ww,       Ds,       Gg,       Hh,    Gs^Fp,    Gs^Fp,    Gs^Fp,       Hh,       Hh,       Hh,       Hh,       Hh,       Hh,       Mm,       Hh,    Gs^Fp,    Gs^Fp,       Hh,       Mm,       Hh,       Mm,       Mm
       Wo,       Wo,       Wo,       Wo,       Wo,       Wo,       Wo,       Wo,       Wo,       Wo,       Wo,       Wo,       Wo,       Wo,       Wo,       Wo,       Ww,       Ww,       Gg,       Gg,    Gs^Fp,    Gg^Ve,    Gs^Fp,       Ch,    Gs^Fp,    Gs^Fp,    Gs^Fp,    Gs^Fp,    Gs^Fp,    Gs^Fp,       Hh,       Hh,       Gg,       Gg,    Gs^Fp,       Gg,       Gg,       Hh,       Hh,       Hh
       Wo,       Wo,       Wo,       Wo,       Wo,       Wo,       Wo,       Wo,       Wo,       Wo,       Wo,       Wo,       Wo,       Wo,       Wo,       Wo,       Ww,       Ds,       Gg,    Gs^Fp,       Ch,    Gs^Fp,    Gs^Fp,    Gs^Fp,    Gs^Fp,    Gs^Fp,       Ch,    Gs^Fp,    Gs^Fp,       Hh,       Gg,       Gg,       Rr,       Gg,    Gg^Ve,    Gs^Fp,    Gs^Fp,       Gg,       Gg,       Gg
       Wo,       Wo,       Wo,       Wo,       Wo,       Wo,       Wo,       Wo,       Wo,       Wo,       Wo,       Wo,       Wo,       Wo,       Wo,       Ww,       Ds,       Ds,       Gg,    Gs^Fp,    Gs^Fp,    Gs^Fp,       Ch,    Gs^Fp,       Ch,    Gs^Fp,       Rr,       Rr,       Rr,       Gg,       Gg,       Rr,       Gg,       Gg,    Gs^Fp,    Gs^Fp,    Gs^Fp,       Ds,       Ww,       Ww
       Wo,       Wo,       Wo,       Wo,       Wo,       Wo,       Wo,       Wo,       Wo,       Wo,       Wo,       Wo,       Wo,       Wo,       Wo,       Ww,       Ww,       Gg,       Gg,    Gs^Fp,    Gs^Fp,    Gs^Fp,    Gg^Ve,     2 Kh,    Gs^Fp,       Rr,    Gs^Fp,    Gs^Fp,    Gs^Fp,       Rr,       Gg,       Gg,       Gg,       Gg,       Ds,    Gs^Fp,       Ww,       Ww,       Gg,       Gg
       Wo,       Wo,       Wo,       Wo,       Wo,       Wo,       Wo,       Wo,       Wo,       Wo,       Wo,       Wo,       Wo,       Wo,       Wo,       Wo,       Ww,       Ww,       Gg,    Gs^Fp,       Ch,    Gs^Fp,       Rr,       Ch,       Rr,       Rr,       Ch,    Gs^Fp,    Gg^Ve,    Gs^Fp,    Gs^Fp,    Gs^Fp,       Gg,       Ds,       Ww,       Ww,       Gg,       Gg,       Mm,       Mm
       Wo,       Wo,       Wo,       Wo,       Wo,       Wo,       Wo,       Wo,       Wo,       Wo,       Wo,       Wo,       Wo,       Wo,       Wo,       Ww,       Ww,       Gg,       Rr,       Rr,    Gs^Fp,       Rr,    Gs^Fp,       Rr,    Gs^Fp,    Gs^Fp,    Gs^Fp,    Gs^Fp,    Gs^Fp,    Gs^Fp,       Gg,       Gg,       Ds,       Ds,       Ww,       Ww,       Gg,       Mm,       Mm,       Mm
       Wo,       Wo,       Wo,       Wo,       Wo,       Wo,       Ww,       Wo,       Wo,       Wo,       Wo,       Wo,       Wo,       Wo,       Ww,       Ww,       Ww,       Gg,       Gg,    Gg^Ve,       Gg,       Gg,       Gg,       Ch,    Gs^Fp,       Gg,       Gg,       Gg,       Gg,       Gg,       Ds,       Gg,       Ds,       Ww,       Ww,       Ww,       Gg,       Gg,       Gg,       Gg
       Wo,       Wo,       Wo,       Ww,       Ww,       Ww,       Gg,       Ww,       Ww,       Ww,       Ww,       Wo,       Wo,       Ww,       Ww,       Ww,       Ww,       Ds,       Ds,       Ds,       Ww,       Gg,       Ww,       Gg,       Gg,       Gg,       Ww,       Ww,       Ww,       Ww,       Ww,       Ds,       Ww,       Ww,       Ww,       Gg,       Mm,       Mm,       Mm,       Mm
       Ww,       Ww,       Ww,       Ww,       Ds,       Ds,       Gg,       Gg,       Gg,       Ww,       Gg,       Ww,       Ww,       Ww,       Ds,       Ds,       Ds,       Ww,       Ww,       Ww,       Ww,       Ww,       Wo,       Ww,       Ww,       Ww,       Wo,       Wo,       Wo,       Ww,       Wo,       Ww,       Wo,       Ww,       Ww,       Gg,       Mm,       Mm,       Mm,       Mm
       Gg,       Gg,       Gg,       Gg,       Gg,       Gg,       Rr,       Gg,       Rr,       Gg,       Gg,       Ds,       Ds,       Ww,       Ww,       Ds,       Ww,       Ww,       Wo,       Ww,       Wo,       Wo,       Wo,       Wo,       Wo,       Wo,       Wo,       Wo,       Wo,       Wo,       Wo,       Wo,       Wo,       Ww,       Ww,       Gg,       Ww,       Mm,       Ww,       Ww
    Gs^Fp,    Gs^Fp,    Gs^Fp,       Gg,       Rr,       Rr,       Gg,       Rr,       Gg,       Rr,       Gg,       Gg,       Gg,       Ds,       Ww,       Ww,       Ww,       Ww,       Wo,       Wo,       Wo,       Wo,       Wo,       Wo,       Wo,       Wo,       Wo,       Wo,       Wo,       Wo,       Wo,       Wo,       Wo,       Wo,       Wo,       Ww,       Wo,       Ww,       Wo,       Wo
    Gs^Fp,    Gs^Fp,    Gs^Fp,       Gg,       Rr,       Gg,       Hh,       Gg,       Gg,       Gg,       Ch,       Gg,       Gg,       Ds,       Ww,       Ww,       Ww,       Wo,       Wo,       Wo,       Wo,       Wo,       Wo,       Wo,       Wo,       Wo,       Wo,       Wo,       Wo,       Wo,       Wo,       Wo,       Wo,       Wo,       Wo,       Wo,       Wo,       Wo,       Wo,       Wo
    Gs^Fp,    Gs^Fp,       Rr,       Rr,       Gg,       Gg,       Hh,       Gg,       Gg,       Ch,     1 Kh,       Ch,       Gg,       Gg,       Ww,       Ww,       Ds,       Ww,       Ww,       Ww,       Wo,       Wo,       Wo,       Wo,       Wo,       Wo,       Wo,       Wo,       Wo,       Wo,       Wo,       Wo,       Wo,       Wo,       Wo,       Wo,       Wo,       Wo,       Wo,       Wo
    Gs^Fp,    Gs^Fp,       Rr,       Gg,       Hh,       Hh,       Hh,    Gg^Vh,       Gg,       Ch,       Ch,       Ch,       Gg,       Gg,       Ww,       Gg,    Gs^Fp,       Ds,       Ds,       Ww,       Ww,       Wo,       Wo,       Wo,       Wo,       Wo,       Wo,       Wo,       Wo,       Wo,       Wo,       Wo,       Wo,       Wo,       Wo,       Wo,       Wo,       Wo,       Wo,       Wo
       Rr,       Rr,       Gg,       Gg,       Hh,       Mm,       Mm,       Hh,       Gg,       Gg,       Gg,       Gg,       Ww,       Ww,       Gg,    Gs^Fp,    Gs^Fp,    Gs^Fp,       Ds,       Ww,       Wo,       Wo,       Wo,       Wo,       Wo,       Wo,       Wo,       Wo,       Wo,       Wo,       Wo,       Wo,       Wo,       Wo,       Wo,       Wo,       Wo,       Wo,       Wo,       Wo
    Gs^Fp,    Gs^Fp,       Gg,       Hh,       Mm,       Mm,       Mm,       Hh,       Hh,       Gg,       Ww,       Ww,    Gs^Fp,    Gs^Fp,    Gs^Fp,    Gs^Fp,    Gs^Fp,    Gs^Fp,       Ds,       Ww,       Ww,       Wo,       Wo,       Wo,       Wo,       Wo,       Wo,       Wo,       Wo,       Wo,       Wo,       Wo,       Wo,       Wo,       Wo,       Wo,       Wo,       Wo,       Wo,       Wo
    Gs^Fp,    Gs^Fp,       Gg,       Hh,       Mm,       Mm,       Mm,       Hh,       Hh,       Gg,       Ww,       Ww,    Gs^Fp,    Gs^Fp,    Gs^Fp,    Gs^Fp,    Gs^Fp,    Gs^Fp,       Ds,       Ww,       Ww,       Wo,       Wo,       Wo,       Wo,       Wo,       Wo,       Wo,       Wo,       Wo,       Wo,       Wo,       Wo,       Wo,       Wo,       Wo,       Wo,       Wo,       Wo,       Wo
